10
16
level2.png
30
100
################
#   ·       D  #
#  ·  V   ·    #
#### ######  # #
#    #       # #
# #######    # #
#    #       # #
#  @ #    ·    #
#    #    ·   D#
################